############
#*...##...g#
#.##.##.##.#
#..........#
#.##.##.##.#
#....##...x#
############